paths	batch	sample	library
/gpfs/commons/groups/sanjana_lab/cdai/TFscreen/data/H2HY7BGXC/star_results/bams/H2HY7BGXC_n01_S01.Aligned.toTranscriptome.out.bam	batch1	S01	rna-seq
/gpfs/commons/groups/sanjana_lab/cdai/TFscreen/data/H2HY7BGXC/star_results/bams/H2HY7BGXC_n01_S02.Aligned.toTranscriptome.out.bam	batch1	S02	rna-seq
/gpfs/commons/groups/sanjana_lab/cdai/TFscreen/data/H2HY7BGXC/star_results/bams/H2HY7BGXC_n01_S03.Aligned.toTranscriptome.out.bam	batch1	S03	rna-seq
/gpfs/commons/groups/sanjana_lab/cdai/TFscreen/data/H2HY7BGXC/star_results/bams/H2HY7BGXC_n01_S04.Aligned.toTranscriptome.out.bam	batch1	S04	rna-seq
/gpfs/commons/groups/sanjana_lab/cdai/TFscreen/data/H2HY7BGXC/star_results/bams/H2HY7BGXC_n01_S05.Aligned.toTranscriptome.out.bam	batch1	S05	rna-seq
/gpfs/commons/groups/sanjana_lab/cdai/TFscreen/data/H2HY7BGXC/star_results/bams/H2HY7BGXC_n01_S06.Aligned.toTranscriptome.out.bam	batch1	S06	rna-seq
/gpfs/commons/groups/sanjana_lab/cdai/TFscreen/data/H2HY7BGXC/star_results/bams/H2HY7BGXC_n01_S07.Aligned.toTranscriptome.out.bam	batch1	S07	rna-seq
/gpfs/commons/groups/sanjana_lab/cdai/TFscreen/data/H2HY7BGXC/star_results/bams/H2HY7BGXC_n01_S08.Aligned.toTranscriptome.out.bam	batch1	S08	rna-seq
/gpfs/commons/groups/sanjana_lab/cdai/TFscreen/data/H2HY7BGXC/star_results/bams/H2HY7BGXC_n01_S09.Aligned.toTranscriptome.out.bam	batch1	S09	rna-seq
/gpfs/commons/groups/sanjana_lab/cdai/TFscreen/data/H2HY7BGXC/star_results/bams/H2HY7BGXC_n01_S10.Aligned.toTranscriptome.out.bam	batch1	S10	rna-seq
/gpfs/commons/groups/sanjana_lab/cdai/TFscreen/data/H2HY7BGXC/star_results/bams/H2HY7BGXC_n01_S11.Aligned.toTranscriptome.out.bam	batch1	S11	rna-seq
/gpfs/commons/groups/sanjana_lab/cdai/TFscreen/data/H2HY7BGXC/star_results/bams/H2HY7BGXC_n01_S12.Aligned.toTranscriptome.out.bam	batch1	S12	rna-seq
/gpfs/commons/groups/sanjana_lab/cdai/TFscreen/data/H2HY7BGXC/star_results/bams/H2HY7BGXC_n01_S13.Aligned.toTranscriptome.out.bam	batch1	S13	rna-seq
/gpfs/commons/groups/sanjana_lab/cdai/TFscreen/data/H2HY7BGXC/star_results/bams/H2HY7BGXC_n01_S14.Aligned.toTranscriptome.out.bam	batch1	S14	rna-seq
/gpfs/commons/groups/sanjana_lab/cdai/TFscreen/data/H2HY7BGXC/star_results/bams/H2HY7BGXC_n01_S15.Aligned.toTranscriptome.out.bam	batch1	S15	rna-seq
/gpfs/commons/groups/sanjana_lab/cdai/TFscreen/data/H2HY7BGXC/star_results/bams/H2HY7BGXC_n01_S16.Aligned.toTranscriptome.out.bam	batch1	S16	rna-seq
/gpfs/commons/groups/sanjana_lab/cdai/TFscreen/data/H2HY7BGXC/star_results/bams/H2HY7BGXC_n01_S17.Aligned.toTranscriptome.out.bam	batch1	S17	rna-seq
/gpfs/commons/groups/sanjana_lab/cdai/TFscreen/data/H2HY7BGXC/star_results/bams/H2HY7BGXC_n01_S18.Aligned.toTranscriptome.out.bam	batch1	S18	rna-seq
/gpfs/commons/groups/sanjana_lab/cdai/TFscreen/data/H2HY7BGXC/star_results/bams/H2HY7BGXC_n01_S19.Aligned.toTranscriptome.out.bam	batch1	S19	rna-seq
/gpfs/commons/groups/sanjana_lab/cdai/TFscreen/data/H2HY7BGXC/star_results/bams/H2HY7BGXC_n01_S20.Aligned.toTranscriptome.out.bam	batch1	S20	rna-seq
/gpfs/commons/groups/sanjana_lab/cdai/TFscreen/data/H2HY7BGXC/star_results/bams/H2HY7BGXC_n01_S21.Aligned.toTranscriptome.out.bam	batch1	S21	rna-seq
/gpfs/commons/groups/sanjana_lab/cdai/TFscreen/data/H2HY7BGXC/star_results/bams/H2HY7BGXC_n01_S22.Aligned.toTranscriptome.out.bam	batch1	S22	rna-seq
/gpfs/commons/groups/sanjana_lab/cdai/TFscreen/data/HFJM7BGXC/star_output/S1.Aligned.toTranscriptome.out.bam	batch2	S01	rna-seq
/gpfs/commons/groups/sanjana_lab/cdai/TFscreen/data/HFJM7BGXC/star_output/S2.Aligned.toTranscriptome.out.bam	batch2	S02	rna-seq
/gpfs/commons/groups/sanjana_lab/cdai/TFscreen/data/HFJM7BGXC/star_output/S3.Aligned.toTranscriptome.out.bam	batch2	S03	rna-seq
/gpfs/commons/groups/sanjana_lab/cdai/TFscreen/data/HFJM7BGXC/star_output/S4.Aligned.toTranscriptome.out.bam	batch2	S04	rna-seq
/gpfs/commons/groups/sanjana_lab/cdai/TFscreen/data/HFJM7BGXC/star_output/S5.Aligned.toTranscriptome.out.bam	batch2	S05	rna-seq
/gpfs/commons/groups/sanjana_lab/cdai/TFscreen/data/HFJM7BGXC/star_output/S6.Aligned.toTranscriptome.out.bam	batch2	S06	rna-seq
/gpfs/commons/groups/sanjana_lab/cdai/TFscreen/data/HFJM7BGXC/star_output/S7.Aligned.toTranscriptome.out.bam	batch2	S07	rna-seq
/gpfs/commons/groups/sanjana_lab/cdai/TFscreen/data/HFJM7BGXC/star_output/S8.Aligned.toTranscriptome.out.bam	batch2	S08	rna-seq
/gpfs/commons/groups/sanjana_lab/cdai/TFscreen/data/HFJM7BGXC/star_output/S9.Aligned.toTranscriptome.out.bam	batch2	S09	rna-seq
/gpfs/commons/groups/sanjana_lab/cdai/TFscreen/data/HFJM7BGXC/star_output/S10.Aligned.toTranscriptome.out.bam	batch2	S10	rna-seq
/gpfs/commons/groups/sanjana_lab/cdai/TFscreen/data/HFJM7BGXC/star_output/S11.Aligned.toTranscriptome.out.bam	batch2	S11	rna-seq
/gpfs/commons/groups/sanjana_lab/cdai/TFscreen/data/HFJM7BGXC/star_output/S12.Aligned.toTranscriptome.out.bam	batch2	S12	rna-seq
/gpfs/commons/groups/sanjana_lab/cdai/TFscreen/data/HFJM7BGXC/star_output/S13.Aligned.toTranscriptome.out.bam	batch2	S13	rna-seq
/gpfs/commons/groups/sanjana_lab/cdai/TFscreen/data/HFJM7BGXC/star_output/S14.Aligned.toTranscriptome.out.bam	batch2	S14	rna-seq
/gpfs/commons/groups/sanjana_lab/cdai/TFscreen/data/HFJM7BGXC/star_output/S15.Aligned.toTranscriptome.out.bam	batch2	S15	rna-seq
/gpfs/commons/groups/sanjana_lab/cdai/TFscreen/data/HFJM7BGXC/star_output/S16.Aligned.toTranscriptome.out.bam	batch2	S16	rna-seq
/gpfs/commons/groups/sanjana_lab/cdai/TFscreen/data/HFJM7BGXC/star_output/S17.Aligned.toTranscriptome.out.bam	batch2	S17	rna-seq
/gpfs/commons/groups/sanjana_lab/cdai/TFscreen/data/HFJM7BGXC/star_output/S18.Aligned.toTranscriptome.out.bam	batch2	S18	rna-seq
/gpfs/commons/groups/sanjana_lab/cdai/TFscreen/data/HFJM7BGXC/star_output/S19.Aligned.toTranscriptome.out.bam	batch2	S19	rna-seq
/gpfs/commons/groups/sanjana_lab/cdai/TFscreen/data/HFJM7BGXC/star_output/S20.Aligned.toTranscriptome.out.bam	batch2	S20	rna-seq
/gpfs/commons/groups/sanjana_lab/cdai/TFscreen/data/HFJM7BGXC/star_output/S21.Aligned.toTranscriptome.out.bam	batch2	S21	rna-seq
/gpfs/commons/groups/sanjana_lab/cdai/TFscreen/data/HFJM7BGXC/star_output/S22.Aligned.toTranscriptome.out.bam	batch2	S22	rna-seq
